XXXXXXXXXXXXXXXXX
X  X       XX   X
X   S  X   XX   X
XXXXXXXX X XXX  X
X        X      X
X  XXXXXXXXXXX  X
X       E       X
XXXXXXXXXXXXXXXXX
