XXXXXXXXXXXXXXXXXXXX
XXXXX              X
X S     XXXX    XXXX
XXXXXXXXX     X X  X
X           XXX X  X
XXEXXX  XXXXX      X
XXXXXXXXXXXXXXXXXXXO
