XXXXXXXXXXXXXXXXXXXX
XXXXX              X
X S     XXXX    XXXX
XXXXXXXXX     X X  X
X           XXX X  X
XX XXX  XXXXX      X
XXXXXXXXXXXXXXXXXXXX
